################
#********###***#
#********#*##**#
#***********#**#
###*****e******#
#**************#
#**************#
#****#*********#
#****#*********#
#****#***#**#**#
#**************#
#*******#******#
#****####******#
#****#*********#
#**************#
################
