###############################
#*****************************#
#*****************************#
#*****************************#
#*****************************#
#*****************************#
#*****************************#
#*****************************#
#*****************************#
#*****************************#
#*****************************#
#*****************************#
#*****************************#
#*****************************#
#*****************************#
#*****************************#
#*****************************#
#*****************************#
#*****************************#
#*****************************#
#*****************************#
#*****************************#
#*****************************#
#*****************************#
#*****************************#
#*****************************#
******************************#
#*****************************#
#*****************************#
#*****************************#
******************************#
#*****************************#
###############################